---*-------*---*------*-------*-----*---*----*----*-------------*---------*-----
**-*****-*-*-*-*-***-**-***-***-*-***-***-*-**--***-****--**-**-***-*****-*-***-
-*-*---***---*-----*----*-*-----*-*-------*-*---*---*-----*---*---*-----*---*-*-
-*---*---*********-******-*******-*-***-***-*-**--**--*-***-*-***-*****-*****-*-
-*******-*-------*-*----------*---*-*---------*---*---*-----*-*---*---*-*-------
-------*---*****-*-**-*-*****-*-***-*-*********-*****-*******-***-*-*-*-*-******
***-********---*-*--***-*---*-*---*-*-------*---*---*-------*---*-*-*-*-*---*---
----*--------***-**-----*-*-*-***-*-*******-*-***-*-*-*-*******-*-*-*-*-***-***-
-****-******-*---*--*****-*-*-*-*---*-----*---*---*-*-*-*-------*---*---*-*-----
------*----*-*-******-----*-*---*****-***-*******-*-***-*-***************-***-**
-******-*-**-*-----*-*-**-*-*-***-*---*-------*---*-----*-*-*---*-----*-------*-
---*----*--*-*****-*-*--*-*-*-------*-*******-*-*****-***-*-*-*-*-***-*-*-***-*-
**-*-****--*-----*-*--*-*-***********-*-----*---*-----*---*---*-*---*---*-*-----
-*---*--*--***-***-**---*-------*---*-*-***-*****-*****-***-***-***-*****-*****-
-*****-***-*-----*--*-*****-*-*-*-***-*-*---*---*---*---*-*---*---------*-----*-
-------*---*****-**-*-----*-*---------*-*-***-*-***-*-***-***-*********-*****---
-*****-*-***-*-*----*******-*-*********-*---*-*-*---*---*-*---*-----*---*-*---**
-*-----*-*-----******-----*-*---*---*-*-***-*-***-*****-*-*-***-*****-***-*-*-*-
-*****-*---***-----*--***-*-***-*-*---*---*-*-----*-*---*---*-*-------*---*-*---
-----*******-*****-*-**---*---*-*-*-*****-*-***-***-*-*****-*-*********-*-*-****
-***-------------*---*--*****-*-***-*-----*---*-*---*-*---*-*-----------*-*-----
---***-*********-******-*-----*-----*-*******-*-***-*-*-*-*-*****-*******-*****-
**-*-*-----*-----*-*----*-*-*-*-*****-----*-*-*-----*---*-*-------*-----*-*-----
---*-*****-****-**-*-****-*-*-*-*---*****-*-*-***********-*********-*-***-*-****
-***-----*----*--*-*----*-*-***-*-*-------*-*-------*---*-*-----*---*-------*---
-*---***-****-**-*-****-*-*-*---*-*********-*******-*-*-*-*****-*-*********-*-*-
-***-*------*-*--*------*-*-*-***-----*-----*-----*-*-*---*-----*---*-----*---*-
-----********-**-*-****-*-*-----*****-*-*-*-*-***-*-*-*****-***-***-*-*-*-*-***-
******-*---*---*-*-*--*-*-*******-----*-*-*---*-*-*-*---*---*-----*-*-*-***---*-
-------*-*-***-*---*-**-*---*---*-*******-*****-*-*-*-*-*-*********-*-*-*-***-**
-*****-*-*-*---*****-*--*****-*-*-*-*-----*-----*-*-*-*-*-*----*----*-*-------*-
-*-------*---***-*-----**---*-*---*-*-*-***-*-***-*-*-*-*-*-**-*-****-***-*-***-
-*****-*******---**-****--*-*-*****-*-*---*-*---*-*-***-*---*---------*---*-*-*-
-----*-*---*---***--*----**---*-*-----***-*****-*-*-----*-***-*********-***-*---
****-*-*-*-***---*--*-**--*****-*-*****-*-*---*---*******---*---*---*---*-----**
--*--*-*-*-*---*-**-*--*--*-----*---*---*-*-*-***-*-*---***-***---*-*-*******-*-
*---****-*-*****----*-***-*-*-*-***-*-***-*-*---*-*---*---*-*-*-*-*-*---*---*-*-
*-***----*-*-----**-*-----*-*-*---*-----*---***-*-*-*****-*-*---*---***-*-*-*---
*-----**-*---**-**--*-***-***-*-***-*-*-*-*-*---***-*-*---*-***---*-*---*-*-***-
****-**--***--*--**-----*-----*-----*-*---*---*-------***-*---*-*-*-*-*-*-*-----